###############
#      @      #
#    b   b    #
# #     *   ###
# #    b    # #
# #    b    # #
# #    b    # #
# # e  b  r # #
#a#    b    # #
###h   b    # #
#    v        #
#           b #
######   ######
#   ao x    o*#
###############
